02040200324420404003240340420432043040240204023003040402
23040320023040340230023400400023040234023042030200420340
02340043024023404004203043040030004023040234023003000400
02340403003040300300303403403000040343040304034030304000
03402304320400403204320402343200234023040234020030430000
02340230400042304000304203406406540765075003023043204000